ID,MonsterID,SpawnType,Params
0,1,0,|2
1,1,0,|3
2,1,0,|1
3,2,0,|1
4,3,0,|1
5,0,0,|2
6,1,0,|2
7,2,0,|2
8,3,0,|2
9,2,0,|1
